NO ./assets/textures/north_wall.xpm
SO ./assets/textures/south_wall.xpm
WE ./assets/textures/west_wall.xpm
EA ./assets/textures/east_wall.xpm

F 120,85,220
C 150,255,255

1111111111111111111111111
1000000001000000000000001
1000000001000000000000001
1000000001000000000000001
1000000000000000000000001
1000000000000000000000001
1000000000000000000000001
1000000000000000000000001
1000000000000000000000001
1000000000000000000000001
1000000000000000000000001
1000000000000000000000001
100000000000000000000N001
1000000000000000000000001
1111111111111111111111111
